James	Dyer
Faith	Short
Amelia	Stewart
Sally	Gray
Dorothy	Mathis
Wanda	Chapman
Joan	Dowd
Dan	Quinn
Gabrielle	Kerr
Oliver	Ball
Justin	Welch
Pippa	Dickens
Alexander	Robertson
Emma	Dickens
Natalie	Roberts
Benjamin	Lee
Deirdre	Fisher
Benjamin	Poole
James	Welch
Jane	Ferguson
Owen	Mathis
Warren	Springer
Simon	Hamilton
Theresa	Sutherland
Sarah	Tucker
Paul	Underwood
Christian	Edmunds
Frank	Lambert
Amelia	Robertson
Julia	Johnston
Sally	Berry
Lily	Butler
Caroline	Thomson
Jan	Martin
Faith	Rees
Peter	McLean
Mary	Jones
Penelope	Rees
Audrey	Oliver
Richard	Smith
Victor	MacDonald
Virginia	Sharp
Vanessa	Paige
Jacob	Lyman
Madeleine	Wallace
Emily	Springer
Rebecca	Mills
Colin	Paige
Austin	Fisher
Leonard	Skinner
Charles	Quinn
Victor	Springer
Amelia	Sharp
Andrea	Ferguson
Julian	Ross
Connor	Mitchell
Blake	King
Nicola	Wilson
Sophie	Terry
Frank	MacLeod
Jane	Baker
Natalie	Martin
Justin	Avery
Fiona	Ogden
Simon	Oliver
Ava	Lambert
Phil	Paige
Jason	Wright
Dan	North
Austin	Wallace